**********
*P  *    *
*    *   *
*        *
*    M   *
*        *
***      *
*  M     *
*       G*
**********